# ##################
# #   # # #      # #
# # # #     #### #
# # #   ### #    # #
#   # #   ######## #
# #   # #      #   #
# # ##########   # #
### #        # # # #
#   # ######## ### #
# ### # # # #  #   #
# #   # # # ## # ###
#   #   #    #     #
# # # #   ##   # # #
# ##################
