# #########
# #     # #
# # ### # #
#   # # # #
# # # # # #
# #   #   #
# # # ### #
# # #   # #
#   # # # #
######### #
